10
10
0 4 9 1
13 5 4 7 10 13 4 5 7 14 
14 13 0 4 0 5 0 7 12 2 
8 7 8 0 1 4 0 4 0 3 
8 7 8 1 6 10 11 10 11 14 
8 4 3 13 3 9 7 9 4 3 
11 10 13 4 7 14 13 5 2 14 
12 3 13 0 6 10 14 14 8 3 
8 7 13 2 11 8 0 3 8 6 
8 6 13 1 6 11 8 4 3 10 
9 2 13 5 1 5 3 9 7 11 
